XXXXXXXXXX
XS0000000X
X0XXXXXX0X
X000000X0X
XXXXXXXX0X
X00000000X
X0XXXXXXXX
XE000000EX
XXXXXXXXXX
